wwwwwwwwwwwwwwwwwww
wp               pw
w wwwwwww wwwwwww w
w w             w w
w w ww ww ww ww w w
w w ww wwwww ww w w
w w             w w
w w ww wwwww ww w w
w w ww w   w ww w w
w w ww ww ww ww w w
w        c        w
w w wwwww wwwww w w
w w     w w     w w
w w www w w www w w
w w w w w w w w w w
w w w w w w w w w w
w w             w w
w wwwwwww wwwwwww w
wp               pw
wwwwwwwwwwwwwwwwwww